2	2	3	3	3	2	2
2	2	3	3	3	2	2
2	2	3	0	3	2	2
2	2	0	0	0	2	2
2	2	45	45	45	2	2
2	2	0	0	0	2	2
2	2	3	0	3	2	2
2	2	3	3	3	2	2
2	2	3	3	3	2	2