2	2	2	2	2	2	2
2	0	0	0	0	0	2
2	45	45	45	45	45	2
2	3	3	3	3	3	2
2	3	3	3	3	3	2
2	3	3	3	3	3	2
2	44	44	44	44	44	2
2	0	0	0	0	0	2
2	2	2	2	2	2	2