2	2	2	2	2	2	2
2	3	3	3	3	3	2
2	3	0	4	0	3	2
2	3	44	44	44	3	2
2	3	0	4	0	3	2
2	3	44	44	44	3	2
2	3	0	4	0	3	2
2	3	3	3	3	3	2
2	2	2	2	2	2	2