2	2	2	2	2	2	2
2	2	2	2	2	2	2
25	25	25	25	25	25	25
0	0	0	0	0	0	0
4	4	4	0	4	4	4
0	0	0	0	0	0	0
25	25	25	25	25	25	25
2	2	2	2	2	2	2
2	2	2	2	2	2	2