2	3	3	3	3	3	2
2	3	0	0	0	3	2
2	3	0	4	0	3	2
2	3	0	4	0	3	2
2	3	0	4	0	3	2
2	3	0	4	0	3	2
2	3	0	4	0	3	2
2	3	0	0	0	3	2
2	3	3	3	3	3	2