2	2	2	3	4	0	0
2	4	0	4	3	4	0
2	3	4	0	4	3	4
2	4	3	4	0	4	3
4	0	4	3	4	0	2
3	4	0	4	3	4	2
4	3	4	0	4	3	2
0	4	3	4	0	4	2
0	0	4	3	4	2	2