3	3	3	3	3	3	3
0	0	0	0	0	0	0
0	45	0	45	0	45	0
0	45	0	45	0	45	0
3	3	3	3	3	3	3
2	2	2	2	2	2	2
2	2	2	2	2	2	2
2	2	2	2	2	2	2
2	2	2	2	2	2	2