2	2	2	2	2	2	2
2	3	3	0	0	0	0
2	3	3	0	4	4	4
2	0	0	0	4	0	3
2	0	4	4	4	0	3
2	0	4	0	0	0	3
2	0	4	3	3	3	3
2	2	2	2	2	2	2
2	2	2	2	2	2	2