0	0	0	4	0	0	0
0	0	4	3	4	0	0
0	4	3	2	3	4	0
4	3	2	2	2	3	4
3	2	2	2	2	2	3
4	3	2	2	2	3	4
0	4	3	2	3	4	0
0	0	4	3	4	0	0
0	0	0	4	0	0	0