2	0	0	0	0	0	2
2	4	0	0	0	4	2
2	4	3	0	3	4	2
2	4	3	4	3	4	2
2	4	3	4	3	4	2
2	4	3	4	3	4	2
2	4	3	0	3	4	2
2	4	0	0	0	4	2
2	0	0	0	0	0	2