2	2	2	2	2	2	2
2	2	2	2	2	2	2
2	3	3	3	3	3	2
2	3	0	0	0	4	2
2	3	0	4	4	4	2
2	3	0	0	0	4	2
24	34	34	34	34	34	24
2	2	2	2	2	2	2
2	2	2	2	2	2	2