2	2	0	0	0	2	2
2	2	2	2	2	2	2
45	45	45	45	45	45	45
0	4	4	0	4	4	0
0	4	4	0	4	4	0
0	4	4	0	4	4	0
44	44	44	44	44	44	44
2	2	2	2	2	2	2
2	2	0	0	0	2	2