4	2	2	2	2	2	4
0	3	2	3	2	3	0
4	2	4	2	4	2	4
0	3	2	3	2	3	0
4	2	4	2	4	2	4
0	3	2	3	2	3	0
44	2	44	2	44	2	44
0	34	2	34	2	34	0
4	2	2	2	2	2	4