4	0	4	0	4	0	4
2	3	2	3	2	3	2
2	2	2	2	2	2	2
2	2	2	2	2	2	2
2	2	2	2	2	2	2
2	2	2	2	2	2	2
2	2	2	2	2	2	2
24	2	24	2	24	2	24
0	4	0	4	0	4	0