2	2	2	2	2	2	2
2	2	2	2	2	2	2
2	0	3	3	3	0	2
2	4	0	3	0	4	2
2	4	4	3	4	4	2
2	44	0	34	0	44	2
24	0	34	3	34	0	24
2	2	2	2	2	2	2
2	2	2	2	2	2	2