2	2	2	2	2	2	2
2	2	2	2	2	2	2
2	35	35	35	35	35	2
2	0	4	0	0	0	2
2	0	4	0	4	0	2
2	0	0	0	4	0	2
2	34	34	34	34	34	2
2	2	2	2	2	2	2
2	2	2	2	2	2	2